+--+--+--+--+--+--+--+--+--+--+--+--+--+--+--+
|S    |     |        |        |     |        |
+  +  +--+  +  +--+  +  +--+--+  +  +  +--+  +
|  |           |     |     |     |     |     |
+  +--+--+  +--+  +  +--+  +  +--+--+--+  +  +
|     |  |     |  |  |     |           |  |  |
+--+  +  +--+  +  +--+  +--+--+--+  +  +--+  +
|     |        |     |     |        |     |  |
+  +--+--+--+--+--+  +--+  +  +--+--+--+  +  +
|  |     |     |  |  |        |  |        |  |
+  +  +  +  +  +  +  +--+--+--+  +  +--+--+  +
|  |  |     |  |        |     |  |  |        |
+  +--+--+--+  +--+--+  +--+  +  +  +  +--+--+
|                    |  |           |  |     |
+--+--+--+--+--+--+  +  +  +--+--+--+  +--+  +
|     |        |     |  |  |        |        |
+  +  +  +--+  +--+--+  +  +--+--+  +--+--+--+
|  |  |     |     |     |     |  |  |     |  |
+  +  +--+--+--+  +  +--+  +  +  +  +--+  +  +
|  |              |  |     |     |     |     |
+  +--+  +  +--+--+  +  +--+--+  +--+  +  +  +
|  |  |  |        |     |        |        |  |
+  +  +  +--+--+  +--+--+  +--+--+  +  +--+--+
|  |  |  |        |     |           |        |
+  +  +  +  +  +--+  +--+--+  +--+--+--+--+  +
|  |     |  |                 |           |  |
+  +--+--+--+--+--+--+--+  +--+--+--+  +--+  +
|  |     |     |     |  |  |        |        |
+  +--+  +  +  +  +  +  +  +--+--+  +--+  +  +
|           |     |     |           |     |  F 
+--+--+--+--+--+--+--+--+--+--+--+--+--+--+--+
